,answer_conditions,satisfaction,familiarity with the topic,unfamiliarity with the topic,diversity/multiple viewpoints,single viewpoint/lack of diversity,balance of the answer, imbalanced answer,biased,unbiased,complete information,missing information/incomplete information,agreement with the answer,disagreement with the answer,coherence/fluency/naturalness/logical/detailed,usefulness,satisfaction.1,no source
0,A1,1,0,0,0,0,0,0,1,0,0,0,0,0,0,0,0,0
1,A1,2,0,0,2,3,0,2,3,1,0,5,0,0,0,0,0,0
2,A1,3,0,1,11,3,0,3,2,3,2,11,0,0,1,0,1,4
3,A1,4,0,4,29,1,4,0,0,3,11,0,1,0,5,0,4,0
4,A2,1,0,1,1,3,0,1,1,0,0,2,0,2,0,0,0,0
5,A2,2,0,2,0,12,0,5,4,0,0,14,1,1,0,0,0,1
6,A2,3,0,0,4,5,0,4,3,1,1,4,0,0,2,0,1,2
7,A2,4,0,1,9,1,1,1,0,3,5,1,1,2,9,0,1,1
8,A3,1,0,1,0,7,0,1,0,0,0,2,0,0,0,0,0,1
9,A3,2,1,0,0,18,0,3,5,0,0,9,0,0,1,0,0,2
10,A3,3,1,2,1,11,0,2,5,0,0,10,3,0,2,0,2,1
11,A3,4,1,1,1,0,1,0,1,2,3,0,3,1,3,0,1,0
